11111111111111111111111111111111
10010000000000000100010000000001
10010000000000000010100000000001
10010000000000000001000000000001
10000000000000000000100000000001
10000000000000000010001000000001
10010000000000001000000100000001
10010000000000100000000010000001
11111111111111111111111111111111