111111111111111111111
100100000000000000001
100100000000000000001
100100000000000000001
100000000000000000001
100000000000000000001
100100001000100000001
100000000000000000001
100000000000000000001
100100001000000000001
100100000000010000001
111111111111111111111