11111111111111111
10000000000000001
10010000100010001
10000000000000001
10000000000000001
10000000000000001
10000000000000001
10010000000000001
10000000010000001
11111111111111111