SO /home/brunobonaldi/Desktop/cub3d/cub3d/assets/textures/south_texture.xpm
C 255,255,255
WE /home/brunobonaldi/Desktop/cub3d/cub3d/assets/textures/west_texture.xpm
EA /home/brunobonaldi/Desktop/cub3d/cub3d/assets/textures/east_texture.xpm
F 42,55,57
NO /home/brunobonaldi/Desktop/cub3d/cub3d/assets/textures/north_texture.xpm

11111111111111
1000000W000001
10000000000001
10000000000001
11111111111111
