NO ./assets/textures/north_texture.xpm
SO ./assets/textures/south_texture.xpm
EA ./assets/textures/east_texture.xpm
WE ./assets/textures/west_texture.xpm
F 128,128,128
C 28,28,28
1111111111111111111111111111111111
1100000000000010100000000000000001
1010110100100000101001000000010101
1010010010101010001001000100010101
1000001000000000000000001000000001
1001010101010101010001100000000001
1000000000100010100000001000010001
1000000000010N01001000000100000011
1000000000001000000000000100000001
1000000000000000000000000100000001
1000010001001000000001010000101001
1110001000000000100010000100000011
1111111111111111111111111111111111