NO ./assets/textures/north_texture.xpm
SO ./assets/textures/south_texture.xpm
EA ./assets/textures/east_texture.xpm
WE ./assets/textures/west_texture.xpm
F 128,128,128
C 28,28,28
1111111111111111111111111
1000000000000000100000001
1000000000000000100000001                                               
1000000000000W00100000001
1000000000000000100000001
1000000000000000100010001          
1000111111111111100010001
1000100000000000000011111
1000100000011110000000001
1000111111110010000000001
1000000000000011110000001
1000000111000000000000001
111111110000000011111111
1000000000000000000000001
1000111111111111111111111
1000100000000000000000001
1000100000111110000000111
1000100000100010000001
1000000001100000000000111
1000000001000000000000001
1111111111111111111111111