NO ./assets/textures/north_texture.xpm
SO ./assets/textures/south_texture.xpm
EA ./assets/textures/east_texture.xpm
WE ./assets/textures/west_texture.xpm
F 42,55,57
C 255,255,255

1111111111111111
1000000000000001
1000000000000001
1000000N00000001
1000000000000001
1111111101111111
