NO ./assets/textures/north_texture.xpm
SO ./assets/textures/south_texture.xpm
EA ./assets/textures/east_texture.xpm
WE ./assets/textures/west_texture.xpm
F 42,55,57
C 255,255,255

   1111111     
   1000001     
  110N000111        11111111111111111111
  100000000111    1110000000000000000001
  10000000000111111000000011111111111111
  1111111110000000000000001
          111110O0001111111
              1000001
              1111111
